第26课			
みる	見る、診る	 看、诊断	
さがす	探す、捜す	 寻找	
おくれる	遅れる	 迟了、没赶上	
じかんにおくれる	時間に遅れる	没赶上（时间）	
まにあう	間に合う	赶上（时间）	
やる		 做、干、搞	
さんかする	参加します	参加	
パーティーにさんかする	パーティーに参加します	参加（晚会）	
もうしこむ	申し込む	 报名、申请	
つごうがいい	都合がいい	 方便（时间上）	
つごうがわるい	都合が悪い	不方便（时间）	
きぶんがいい	気分がいい	 感觉舒服	
きぶんがわるい	気分が悪い	感觉不舒服	
しんぶんしゃ	新聞社	报社	
じゅうどう	柔道	 柔道	
うんどうかい	運動会	 运动会	
ばしょ	場所	 场所、地点	
ボランティア 	Volunteer	 志愿者（活动）	
~べん	～弁	 ～方言	
こんど	今度	 这次、这回、下次、下回	
ずいぶん		 很、极、相当	
ちょくせつ	直接	 直接	
いつでも		 随时	
どこでも		在任何地方	
だれでも		 任何人都	
なんでも	何でも	 什么都	
こんな～		 这样的～	
そんな～		 那样的～	
あんな～		 那样的～	
NHK		 日本广播协会（广播公司）	
こどもの日		 （日本）男孩节	
エドヤストア		 江户屋商店（虚构的店名）	
会　話 			
かたづきる	荷物が片付きる	 收拾（行李）	
ごみ		 垃圾	
だす	ごみを出す	 扔掉、倒（垃圾）	
もえる	ごみが燃える	（垃圾）燃烧	
げつ　すい　きん	月　水　金	 星期一、星期二、星期五	
おきば	置き場	 放置的地方	
よこ	横	 旁边	
びん	瓶	 瓶子	
かん	缶	 罐子	
「お」ゆ	「お」湯	 热水	
ガス 	Gas	 煤气	
～がいしゃ	～会社	 ～公司	
れんらくする	連絡する	 联系	
こまったなあ	困ったなあ	 怎么办呢？	
読み物			
でんしメール	電子メール	 电子邮件	
うちゅう	宇宙	 宇宙	
こわい	怖い	 害怕（的）、可怕（的）	
うちゅうせん	宇宙船	 宇宙飞船	
べつの	別の	 别的	
うちゅうひこうし	宇宙飛行士	 宇航员	
どいたかお	土井隆雄	 日本宇航员，1955～	
第27课			
かう	飼う	饲养、喂	
たつ	建つ	修建	
はしる	走る	跑 	
「みちをはしる」	「道を走る」	在路上【跑】	
とる	取る	取得	
とる「やすみを～」	取る「休みを～」	请【 假】	
みえる	見える	看得见	
みえる「やまが～」	見える「山が～」	看得见 【山】	
きこえる	聞こえる	听得见	
きこえる「おとが～」	聞こえる「音が～」	听得见【声音】	
できる	出来る	产生、形成、完成、能	
できる「くうこうが～」	出来る「空港が～」	建好【机场】	
ひらく	開く	开	
ひらく「教室を～」	開く「教室を～」	开【讲座】	
ペット	Pet	宠物	
とり	鳥	鸟	
こえ	声	声音	
なみ	波	波浪	
はなび	花火	烟花	
けしき	景色	景色	
ひるま 　　　	昼間	白天	
むかし	昔	从前、以前	
どうぐ	道具	工具	
じどうはんばいき	自動販売機	自动售货机	
つうしんはんばい	通信販売	邮递购物、邮购	
クリーニング	Cleaning	（干）洗、洗衣	
マンション	Mansion	高级公寓	
だいどころ	台所	厨房	
～きょうしつ	～教室	教室	
パーティールーム	Party room	晚会厅	
～ご	～後	～之后（时间、期间）	
～しか 		只有～	
ほかの 		之外的	
はっきり 		清楚地	
ほとんど 		几乎所有的（用于肯定句）	
		几乎都不（用于否定句）	
会　話			
にちようだいく	日曜大工	星期天做木匠活儿	
ほんだな	本棚	书架	
ゆめ	夢	梦	
いつか 		什么时候	
いえ	家	家、房子	
すばらしい		极好地、很棒的	
読み物			
こどもたち	子どもたち	孩子们	
だいすき（な）	大好き（な）	非常喜欢	
まんが	漫画	漫画、连环画	
しゅじんこう	主人公	主人公	
かたち	形	形状、样子	
ロポット		机器人	
ふしぎ（な）	不思議（な）	不可思议（形动）	
ポケット		口袋	
たとえば	例えば	例如	
つける	付ける	戴上	
じゆうに	自由に	自由地	
そら	空	天空	
とぶ	飛ぶ	飞、飞翔	
じぶん	自分	自己	
しょうらい	将来	将来	
ドラえもん		机器猫	
第28课			
うれる	売れる	卖、出售	
「パンがうれる」	「Panが売れる」	出售【面包】	
おどる	踊る	跳舞	
かむ	咬む	嚼、咬	
えらぶ	選ぶ	选择	
ちがう	違う	不同	
かよう	通う	通过	
「だいがくにかよう」	「大学に通う」	上【大学】	
メモする	Memoする	记笔记	
まじめ「な」	真面目「な」	认真	
ねっしん「な」	熱心「な」	热心	
やさしい	優しい	和蔼的、温和的	
えらい	偉い	了不起的	
ちょうどいい		正好	
しゅうかん	習慣	习惯	
けいけん	経験	经验	
ちから	力	力量、力气	
にんき	人気	人缘、受欢迎	
かたち	形	形状、样子	
いろ	色	颜色	
あじ	味	味道	
ガム	Gum	口香糖	
しなもの	品物	商品、物品	
ねだん	値段	价格、价钱	
きゅうりょう	給料	工资、报酬	
ボーナス	Bonus	奖金、红包	
ばんぐみ	番組	节目	
ドラマ	Drama	电视剧	
しょうせつ	小説	小说	
しょうせつか	小説家	小说家	
かしゅ	歌手	歌手	
かんりにん	管理人	管理人	
むすこ	息子	（我的）儿子	
むすこさん	息子さん	（您的）儿子	
むすめ	娘	（我的）女儿	
むすめさん	娘さん	（您的）女儿	
じぶん	自分	自己	
しょうらい	将来	将来	
しばらく	暫く	不久	
たいてい	大抵	大概、通常、几乎	
それに		而且	
それで		所以、因此	
会 話			
「ちょっと」お願いが　あるんですが		我有件事想麻烦您一下	
ホームステイ	Home stay	外国人短期住在当地人家里体验生活	
かいわ	会話	会话	
おしゃべりする	お喋りする	聊天	
読み物			
おしらせ	お知らせ	通知	
ひにち	日にち	日子	
たいいくかん	体育館	体育馆	
むりょう	無料	免费	
第29课			
あく	開く（自）	开着	
「ドアがあく」	「Doorが開く」	【门】开着	
しまる	閉まる	关着	
「ドアがしまる」	「Doorが閉まる」	【门】关着	
つく		点亮、点燃	
「でんきがつく」	「電気がつく」	点【灯】	
きえる	消える	熄灭，关着	
「でんきがきえる」	「電気が消える」	【灯】关着	
こむ	込む	拥挤	
「みちが～」	「道が～」	【道路】拥挤	
すく	空く	空，空闲	
「みちが～」	「道が～」	【道路】不拥挤	
こわれる	壊れる	坏了	
「いすが～」	「椅子が～」	【椅子】坏了	
われる	割れる	破碎、裂开	
「コップが～」	「Cupが～」	【杯子】破了	
おる	折る	倒了	
「きが～」	「木が～」	树倒了	
やぶれる	破れる	破、破损	
「かみが～」	「紙が～」	【纸】撕烂了	
よごれる	汚れる	脏、污染	
「ふくが～」	「服が～」	【衣服】脏了	
つく	付く	附有、带有	
「ポケットが～」	「Pocketが～」	带有【口袋】	
はずれる	外れる	脱落、掉下	
「ボタンが～」	「Buttonが～」	【纽扣】掉了	
とまる	止まる	停住、停止、止住	
「エレベーターが～」	「Elevatorが～」	【电梯】停了	
まちがえる	間違える	弄错	
おとす	落とす	丢失、弄丢	
かかる	掛かる	挂，悬挂	
「かぎが～」	「鍵が～」	上着【锁】	
「お」さら	「お」皿	盘子	
「お」ちゃわん	「お」茶碗	饭碗	
コップ	Cup	杯子	
ガラス	Glass	玻璃	
ふくろ	袋	袋子	
さいふ	財布	钱包	
えだ	枝	树枝	
えきいん	駅員	车站工作人员	
このへん	この辺	这一带、这附近	
～へん	～辺	～的附近	
このくらい		这样大小的	
おさきにどうぞ	お先にどうぞ	您先请	
「ああ」よかった		【啊】太好了（用于放心时）	
会　話			
いまのでんしゃ	今の電車	刚才的电车	
わすれもの	忘れ物	遗忘的东西	
～がわ	～側	～一侧的、～一边的	
ポケット	Pocket	口袋	
おぼえていません	覚えていません	不记得了	
あみだな	網棚	行李网	
たしか	確か	我记得、应该是、可能	
読み物			
じしん	地震	地震	
かべ	壁	墙壁	
はり	針	（钟表的）指针	
さす	指す	指	
えきまえ	駅前	车站前	
たおれる	倒れる	倒、倒下	
にし	西	西	
ほう	方	方向	
第30课			
はる               	貼る	贴、张挂	
かける	掛ける	挂、悬挂	
かざる	飾る	装饰	
ならべる	並べる	排列	
うえる	植える	种植	
もどる	戻る	还、归还、送回	
まとめる	纏める	汇集、收集、整理、归纳	
かたづける	片付ける	收拾、整理	
しまう		放回原处、回收	
きめる	決める	决定	
しらせる	知らせる	通知	
そうだんする	相談する	商量、讨论	
よしゅうする	予習する	预习	
ふくしゅうする	復習する	复习	
そのままにする		保持原状	
おこさん	お子さん	（您的）孩子	
じゅぎょう	授業	课、课程	
こうぎ	講義	上课、讲义	
ミーティング	Meeting	会议	
よてい	予定	计划、预定	
おしらせ	お知らせ	通知	
あんないしょ  	案内書	（旅行）指南	
カレンダー	Calendar	日历	
ポスター	Post	宣传画	
ごみばこ	ゴミ箱	垃圾箱	
にんぎょう	人形	娃娃、偶人	
かびん	花瓶	花瓶	
かがみ	鏡	镜子	
ひきだし	引き出し	抽屉	
げんかん	玄関	大门、入口	
ろうか	廊下	走廊、过道	
かべ	壁	墙壁	
いけ	池	水池、池塘	
こうばん	交番	派出所	
もとのところ	元の所	原来的地方	
まわり	周り	周围、附近	
まんなか	真ん中	正中间	
すみ	隅	角落	
まだ 		还	
～ほど 		大约～、大概～	
会　話			
よていひょう	予定表	日程、时间表	
ごくろうさま	ご苦労様	您辛苦了。（用于上司或年长对手下的工作表示感谢）	
きぼう	希望	要求、希望	
何か ご希望が ありますか		您有什么要求吗？	
ミュージカル	Musical	音乐剧、音乐的	
それは　いいですね 		那太好了	
ブロードウェイ		百老汇	
読み物			
まるい	丸い	圆的	
つき	月	月亮	
ある～	ある～	某个～、一个～	
ちきゅう	地球	地球	
うれしい	嬉しい	高兴的、愉快的、快乐的	
いや（な）	嫌（な）	讨厌	
すると		于是、这么一来	
めがさめます	目が覚めます	醒、睡醒	
第31课			
はじまる	始まる	开始	
「しきが～」	「式が～」	【仪式】开始	
つづける	続ける	继续	
みつける	見つける	找、寻找	
うける	受ける	参加	
「しけんを～」	「試験を～」	参加【考试】	
にゅうがくする	入学する	进、上	
「だいがくに～」	「大学に～」	上【大学】	
そつぎょうする	卒業する	毕业	
「だいがくに～」	「大学に～」	大学【毕业】	
しゅっせきする	出席する	出席	
「かいぎに～」	「会議に～」	出席【会议】	
きゅうけいする	休憩する	休息	
れんきゅう	連休	连休	
さくぶん	作文	作文、写作	
てんらんかい	展覧会	展览会	
けっこんしき	結婚式	结婚典礼	
「お」そうしき	「お」葬式	葬礼	
しき	式	仪式	
ほんしゃ	本社	总社、本社、总公司	
してん	支店	分社、子公司	
きょうかい	教会	教堂	
だいがくいん	大学院	大学院、研究生院	
どうぶつえん	動物園	动物园	
おんせん	温泉	温泉	
おきゃく「さん」	お客「さん」	客人、游客、顾客	
だれか		某人	
～のほう	～の方	～的方向、～的方面	
ずっと		一直	
会　話			
のこる	残る	留下、残留	
つきに	月に	每个月、每月	
ふつうの	普通の	平常的、一般的	
インターネット		互联网、因特网	
読み物			
むら	村	村、村庄	
えいがかん	映画館	电影院	
いや　（な）	嫌（な）	讨厌、令人讨厌	
そら	空	天空	
とじる	閉じる	闭上、关上	
とかい	都会	城市	
こどもたち	子供たち	孩子们	
じゆうに	自由に	自由地	
せかいじゅう	世界中	全世界	
あつまる	集まる	集中	
うつくしい	美しい	美丽的	
しぜん	自然	自然	
すばらしい	素晴らしい	美好、优点	
きがつく	気が付く	意识到、注意到、发现	
第32课			
うんどうする	運動する	运动	
せいこうする	成功する	成功	
しっぱいする	失敗する	失败	
「しけんに～」	「しけんに～」	【考试】失败	
ごうかくする	合格する	合格	
もどる	戻る	返回	
やむ	止む	停	
「あめが～」	「雨が～」	【雨】停了	
はれる	晴れる	晴朗	
くもる	曇る	阴天	
ふく	吹く	吹、刮	
「かぜが～」	「風が～」	刮【风】	
なおる	治る、直る	治愈、治疗、修好、复原	
「びょうきがなおる」	「病気が治る」	治好【病】	
「こしょうがなおる」	「故障が直る」	排除【故障】	
つづく	続く	持续、继续	
「ねつが～」	「熱が～」	持续【发烧】	
ひく	引く	引	
「かぜが～」	「風邪が～」	患【感冒】	
ひやす	冷やす	冰、冰镇	
しんぱい「な」	心配「な」	担心的	
じゅうぶん「な」	十分「な」	足够的	
おかしい		奇怪的、可疑的	
うるさい		吵闹的、烦人的	
やけど		烧伤、烫伤	
けが		伤	
せき		咳嗽	
インフルエンザ	Influenza	流行性感冒	
そら	空	天空	
たいよう	太陽	太阳	
ほし	星	星星	
つき	月	月亮	
かぜ	風	风	
きた	北		
みなみ	南		
にし	西		
ひがし	東		
すいどう	水道	水稻、水管	
エンジン	Engine	发动机	
チーム	Team	队	
こんや	今夜	今天晚上	
ゆうがた	夕方	傍晚	
まえ	前	以前	
おそく	遅く	晚（时间上的）	
こんなに		这么（近称	
そんなに		那么（中称）	
あんなに		那么（远称）	
もしかしたら		如果、万一、或许（副词）	
それは　いけませんね		那可不行啊！	
会　話			
げんき	元気	健康、精神焕发	
い	胃		
はたらきすぎ	働き過ぎ	工作过度劳累	
ストレス		疲劳、紧张	
むりをする	無理をする	勉强	
ゆっくりする		好好休息、慢慢做	
読み物			
ほしうらない	星占い	占星术、星相	
おうしざ	牡牛座	金牛座	
こまる	困る	麻烦了、糟了	
たからくじ	宝くじ	彩票	
あたる	当たる	中、命中	
けんこ	健康		
れんあい	恋愛		
こいびと	恋人		
おかねもち	お金持ち	有钱人、大款	
第33课			
にげる	逃げる	逃走	
さわぐ	騒ぐ	吵嚷、吵闹	
あきらめる	諦める	放弃、死心	
なげる	投げる	扔、投	
まもる	守る	保持、坚持	
あげる	上げる	举起、抬起	
さげる	下げる	放下、放低	
つたえる	伝える	转告、转达	
ちゅういする	注意する	小心、注意	
「くるまに～」	「車に～」	注意【汽车】	
はずす	外す	离开	
「せきを～」	「席を～」	离开【座位】	
だめ「な」		不行、不好	
せき	席	座位	
ファイト	Fight	加油	
マーク	Mark	标记、标志	
ボール	Ball	球	
せんたくき	洗濯機	洗衣机	
~き	～機		
きそく	規則		
しようきんし	使用禁止	禁止使用	
たちいりきんし　	立入禁止	禁止入内	
いりぐち	入口		
でぐち	出口		
ひじょうぐち	非常口	紧急出口	
むりょう	無料	免费	
ほんじつきゅうぎょう	本日休業	本日休息	
えいぎょうちゅう	営業中	正在营业、营业中	
しようちゅう	使用中	正在使用	
～ちゅう	～中	正在～、～中	
どういう～		怎样的～、什么样的～	
もう		已经、不再（和否定一起使用）	
あと～			
会　話			
ちゅうしゃいはん	駐車違反	违规停车	
そりゃあ		那么	
～いない	～以内	～以内	
けいさつ	警察		
ばっきん	罰金	罚款	
読み物			
でんぽう	電報	电报	
ひとびと	人々	人们	
きゅうよう	急用	急事	
うつ	打つ	发、打	
でんぽうだい	電報代	电报费	
できるだけ		尽量、尽力	
みじかく	短く	简短地	
また		另外、再者	
たとえば	例えば	例如	
キトク		病危	
おもい	重い	重、严重	
あす	明日	明天	
るす	留守	不在	
るすばん	留守番	看家、看家人	
お「いわい」	お祝い	祝贺、庆祝	
なくなる	亡くなる	去世	
かなしみ	悲しみ	悲伤、悲痛	
りようする	利用する	利用、使用	
第34课			
みがく	磨く	刷	
「はを～」	「歯を～」	刷【牙】	
くみたてる	組み立てる	组装	
おる	折る	折断、弯曲	
きがつく	気が付く	注意	
「わすれものに～」	「忘れ物に～」	注意【别忘东西】	
つける	浸ける	蘸上	
「しょうゆを～」	「醤油を～」	蘸上【酱油】	
みつかる	見つかる	找到	
「かぎが～」	「鍵が～」	找到【钥匙】	
する		系	
「ネクタイを～」	「Necktie～」	系【领带】	
しつもんする	質問する	提问	
ほそい	細い	瘦的、细的	
ふとい	太い	胖的、粗的	
ぼんおどり	盆踊り	盂兰盆节舞	
スポーツクラブ	Sports club	体育俱乐部、运动俱乐部	
かぐ	家具	家具	
キー	Key	钥匙	
シートベルト	Seatbelt	安全带	
せつめいしょ	説明書	说明书	
ず	図	图	
せん	線	线	
やじるし	矢印	箭头	
くろ	黒		
しろ	白		
あか	赤		
あお	青		
こん	紺	深蓝	
きいろ	黄色		
ちゃいろ	茶色		
しょうゆ	醤油		
ソース	Sauce	酱汁、沙司	
～か～ 		～或者～	
ゆうべ	昨夜	昨晚	
さっき 		刚才	
会　話			
さどう	茶道		
おちゃをたてる	お茶を点てる	泡茶、沏茶	
さきに	先に	首先、先（表示行动的顺序）	
のせる	載せる	放上	
これでいいですか 		这样可以吗？	
にがい	苦い	苦的	
読み物			
おやこどんぶり	親子どんぶり	鸡肉鸡蛋盖浇饭	
ざいりょう	材料		
～ぶん	～分		
とりにく	鳥肉		
～クラム		～克	
～こ	～個	～个（计算小物件品的量词）	
たまねぎ		洋葱	
よんぶんのいち	４分の1		
ちょうみりょう	調味料	调味品	
なべ		锅	
ひ	火		
ひにかける	火にかける	放在火上	
にる	煮る　　　　（1）	煮	
にえる	煮える	煮熟	
第35课			
さく	咲く	开	
「はなが～」	「花が～」	开【花】	
かわる	変わる	变	
「いろが～」	「色が～」	变【色】	
こまる	困る	麻烦、为难	
つける	付ける	加上	
「まるを～」	「丸を～」	画【圈】	
ひろう	拾う	拾、捡	
かかる		打、挂	
「でんわが～」	「電話が～」	打【电话】	
らく「だ」	楽「だ」	轻松的、容易的	
ただしい	正しい	正确的	
めずらしい	珍しい	少见的、不寻常的、珍奇的	
かた	方	位（对「ひと」的尊敬说法）	
むこう	向こう	对面	
しま	島		
むら	村	村庄	
みなと	港	港口	
きんじょ	近所	邻居	
おくじょう	屋上	屋顶	
かいがい	海外	海外、国外	
やまのぼり	山登り	爬上、登山	
ハイキング	Hiking	郊游	
きかい	機会	机会	
きょか	許可	许可	
まる	丸	圆圈	
そうさ	操作	操作	
ほうほう	方法	方法	
せつび	設備	设备	
カーテン	Curtain	窗帘	
ひも		绳子、绳索	
ふた	蓋	盖、盖子	
は	葉	叶子	
きょく	曲	乐曲	
たのしみ	楽しみ	快乐的、愉快的、乐趣	
もっと		更、更加 （副词）	
はじめに	始めに	最初、开始	
これで終わります	これで終わります	到此结束	
アフリカ		非洲	
会　話			
それなら		那样的话、如果是那样	
やこうバス	夜行バス	夜行公共汽车	
りょこうしゃ	旅行社		
くわしい	詳しい	详细的	
スキーじょう	スキー場	滑雪场	
読み物			
しゅ	朱	红色的	
まじわる	交わる	打交道、来往	
ことわざ	諺	谚语	
なかよくする	仲良くする	友好交往	
ひつよう（だ）	必要（だ）	必要的、必须的	
第36课			
とどく	届く	送到，到达	
「にもつが～」	「荷物が～」	送【行李】	
でる　　　　　　　　　１	出る	参加、出席、出场	
「しあいに～」	「試合に～」	参加【比赛】	
うつ	打つ	打	
「ワープロを～」		打【文字处理机】	
ちょきんする	貯金する	储蓄、存钱	
ふとる	太る	长胖	
やせる	痩せる	变瘦	
すぎる	過ぎる	（时间等）过去、逝去	
「７じを～」	「７時を～」	过【7点】	
なれる	慣れる	适应	
「しゅうかんい～」	「習慣に～」	适应【习惯】	
かたい	硬い	硬的	
やわらかい	軟らかい	软的	
でんし～	電子～	电子～	
けいたい～	携帯～	便携式～	
こうじょう	工場	工厂	
けんこう	健康	健康	
けんどう	剣道	剑道	
まいしゅう	毎週	每周、每星期	
まいつき	毎月		
まいとし/まいねん	毎年		
やっと		终于  （副词）	
かなり		相当、很	
かならず	必ず	一定、肯定	
ぜったいに	絶対に	绝对（和否定形一起使用）	
じょうずに	上手に	擅长	
できるだけ	出来るだけ	尽量  （副词）	
このごろ		这些天、最近	
～ずつ		每～、各～	
そのほうが～		那样更～	
ショパン		肖邦	
会　話			
おきゃくさま	お客様	客人、顾客	
とくべつ「な」	特別「な」	特别的	
していらっしゃいます		正在做～(しています的尊敬语)	
すいえい	水泳	游泳	
～とか、～とか		～或、～等	
タンゴ		探戈	
チャレンジします		挑战	
きもち	気持ち	心情、情绪	
読み物			
のりもの	乗り物	交通工具	
れきし	歴史	历史	
～せいき	～世紀		
とおく	遠く	远、远处	
きしゃ	汽車	火车	
きせん	汽船	汽船	
おおぜいの～	大勢の～	很多的（人）	
はこぶ	運ぶ	运送	
とぶ	飛ぶ	飞、飞翔	
あんぜん「だ」	安全「だ」	安全的	
うちゅう	宇宙		
ちきゅう	地球		
ライトきょうだい	ライト兄弟	莱特兄弟	
第37课			
ほめる	褒める	表扬	
しかる	叱る	批评	
さそう	誘う	邀请	
おこす	起こす	叫醒	
しょうたいする	招待する	招待	
たのむ	頼む	请求、要求、拜托	
ちゅういする	注意する	提醒、警告	
とる	取る	抢、偷	
ふむ	踏む	踩	
こわす	壊す	弄坏、弄碎	
よごす	汚す	弄脏	
おこなう	行う	举行	
ゆしゅつする	輸出する	出口	
ゆにゅうする	輸入する	进口	
ほんやくする	翻訳する	翻译	
はつめいする	発明する	发明	
せっけいする	設計する	设计、规划	
こめ	米	大米	
むぎ	麦	麦子	
せきゆ	石油	石油	
げんりょう	原料	原料	
デート	Date	约会	
どろぼう	泥棒	小偷、强盗	
けいかん	警官	警察	
けんちくか	建築家	建筑师	
かがくしゃ	科学者	科学家	
まんが	漫画	漫画、卡通、连环画	
せかいじゅう	世界中	全世界	
～じゅう	~中	全～、整个～	
～に　よって		根据～、由～	
よかったですね		太好了、太棒了	
ドミニカ		多米尼加共和国	
サウジアラビア		沙特阿拉伯	
会　話			
うめたてる	埋め立てる	填埋	
ぎじゅつ	技術	技术	
とち	土地	土地	
そうおん	騒音	噪音	
りようする	利用する	利用、用	
アクセス	Access	通路、方法	
読み物			
～せいき	～世紀	～世纪	
ごうか（だ）	豪華（だ）	豪华	
ちょうこく	彫刻	雕刻	
ねむる	眠る	睡	
はる		雕	
なかま	仲間	朋友、友人、伙伴儿	
そのあと		之后、然后	
いっしょうけんめい	一生懸命	拼命	
ねずみ	鼠	老鼠	
いっぴきもいません	一匹もいません	一只也没有	
ねむりねこ	眠り猫	熟睡的猫	
第38课			
そだてる	育てる	养育、抚育、抚养	
はこぶ	運ぶ	运送	
なくなる	亡くなる	去世	
にゅういんする	入院する	住院	
たいいんする	退院する	出院	
いれる	入れる	打开	
「でんげんを～」	「電源を～」	打开【电源】	
きる	切る　　　　　　　　（５）	切、切断	
「でんげんを～」	「電源を～」	切断【电源】	
かける	掛ける	锁	
「かぎを～」	「鍵を～」	锁上【锁】	
きもちがいい	気持ちがいい	舒服、舒畅	
きもちがわるい	気持ちが悪い	不舒服、不舒畅	
おおきな～	大きな～	大的～	
ちいさな～	小さな～	小的～	
あかちゃん	赤ちゃん	婴儿	
しょうがっこう	小学校	小学	
ちゅうがっこう	中学校	中学	
えきまえ	駅前	车站前	
かいがん	海岸	海岸、海滩	
うそ	嘘	撒谎、谎言	
しょるい	書類	文件	
でんげん	電源	电源	
～せい	～製	～制造	
「あ、」いけない		【噢】糟了、不好	
おさきに「しつれいする	お先に「失礼する」	我先～	
会話			
かいらん	回覧	传阅	
けんきゅうしつ	研究室	研究室	
きちんと		整洁的、整齐的、很好的	
せいりします	整理します	整理、收拾	
～と　いう　ほん	～と　いう　ほん	一本叫～的书	
～さつ	～冊	～本	
はんこ		印章	
おす	押す	盖	
「はんこを～」		盖章	
読み物			
ふたご	双子	孪生子	
しまい	姉妹	姐妹	
にている	似ている	相像、相似	
せいかく	性格		
おとなしい	大人しい	文静的、老实的、安静的	
せわ　をする	世話をする	照顾	
			
じかん　が　たつ	時間が経つ	时间流逝	
だいすき	大好き	很喜欢的	
～てん	～点	～分	
クラス		班、班级	
けんかする	喧嘩する	吵架、打架	
ふしぎ	不思議（だ）	不可思议的	
第39课			
こたえる	答える	回答	
「しつもんに～」	「質問に～」	回答【问题】	
たおれる	倒れる	倒塌	
「ビルが～」	[Buildingが～」	【大楼】倒塌	
やける	焼ける	着火、燃烧	
「うちが～」	「家が～」	【房屋】着火	
「パンが～」	「Panが～」	烤【面包】	
「にくが～」	「肉が～」	烤【肉】	
とおる	通る	通过	
「みちを～」	「道を～」	痛过【街道】	
しぬ	死ぬ	死	
びっくりする	吃驚する	吃惊	
がっかりする	がっかりする	失望	
あんしんする	安心する	安心、放心	
ちこくする	遅刻する	迟到	
けんかする	喧嘩する	早退	
りこんする	離婚する	吵架	
ふくざつ	複雑（だ）	离婚	
じゃま	邪魔（だ）	复杂的	
きたない	汚い	肮脏的	
うれしい	嬉しい	高兴的	
かなしい	悲しい	悲伤的	
はずかしい	恥ずかしい	可耻的、害羞的	
じしん	地震		
たいふう	台風		
かじ	火事	火灾	
じこ	事故		
「お」みあい	「お」見合い	相亲	
でんわだい	電話代	电话费	
～だい	～代	～费	
フロント	Front	前台、问询	
～ごうしつ	～号室	～号房间	
あせ	汗		
タオル	Towel	毛巾	
せっけん	石鹸	肥皂、香皂	
おおぜい	大勢	许多人	
おつかれさまでした	おつかれさまでした	您辛苦了（一般用于同事或上对下）	
うかがいます	伺います	去、拜访（行く的自谦说法）	
会話			
とちゅうで	途中で	途中、路上、半途	
トラック	Track	卡车	
ぶつかる	ぶつかる	碰、撞	
ならぶ	並ぶ	排队、并排	
読み物			
おとな	おとな	成年人	
ようふく	洋服	西式服装	
せいようかする	西洋化する	西化	
あう	合う	适合、合适	
いまでは	今では	现在	
せいじんしき	成人式	成人仪式	
第40课			
かぞえる	数える	数	
はかる	計る、量る	量、称	
たしかめる	確かめる	确认	
あう	合う	符合	
「サイズが～」	「Sizeが～」	【尺寸】符合	
しゅっぱつする	出発する	出发	
とうちゃくする	到着する	到达	
よう	酔う	喝醉	
きけん「な」	危険「な」	危险的	
ひつよう「な」	必要「な」	必要的	
うちゅう	宇宙		
ちきゅう	地球		
ぼうねんかい	忘年会	辞旧迎新会	
しんねんかい	新年会	新年联欢会	
にじかい	二次会	二次聚会	
たいかい	大会		
マラソン	Marathon	马拉松	
コンテスト	Contest	比赛、竞赛	
おもて	表	表面、正面	
うら	裏	背面、里面	
へんじ	返事	回答、答复	
もうしこみ	申し込み	申请	
ほんとう	本当	真的、事实	
まちがい	間違い	错、错误	
きず	傷	伤、缺陷	
ズボン	Jupon	裤子	
ながさ	長さ	长度	
おもさ	重さ	重量	
たかさ	高さ	高度	
おおきさ	大きさ	大小	
～びん	～便	～航班	
～ごう	～号	～次（火车车次等）	
～こ	～個	～个（数小件物品的量词）	
～ほん（～ぽん、～ばん）	～本	～枝、条（数细长物品的量词）	
～はい（～ぱい、～ばい）	～杯	～杯	
～キロ	～Kilo	～公斤、公里	
～グラム	～Gram	～克	
～センチ	～Centy	～厘米	
～ミリ	～Mili	～毫米	
～いじょう	～以上	～以上、不少于～、超过～	
～いか	～以下	～以下、不多于～、低于～	
さあ		喂、	
会話			
どうでしょうか		～怎么样？	
クラス	Class	班级	
テスト	Test	考试、测试	
せいせき	成績		
ところで		（转化话题）可是	
いらっしゃいます		来（来ます的尊敬语）	
ようす	様子	情况、情形、样子	
読み物			
じけん	事件		
オートバイ		摩托车	
ばくだん	爆弾	炸弹	
つむ	積む	堆积起来、装	
うんてんしゅ	運転手	司机	
はなれた	離れた	相距	
が		但是	
きゅうに	急に	突然	
うごかす	動かす	移动、开动、变动	
いっしょけんめい	一所懸命	拼命	
はんにん	犯人		
てにいれる	手に入れる	到手、得到	
いまでも	今でも	现在就	
うわさする	噂する	谣传	
第41课			
いただきます		手下（もらいます）的自谦	
くださいます		给（くれます）的尊敬	
やります		给（对地位低的人或动植物）	
よびます	呼びます	邀请	
とりかえます	取り替えます	交换	
しんせつにします	親切にします	对...友好和善	
かわいい	可愛い	可爱的	
おいわい	お祝い	祝贺，礼物	
おとしだま	お年玉	压岁钱	
「お」みまい	「お」見舞い	探病 探视 慰问	
きょうみ	興味	兴趣	
じょうほう	情報	资讯 情报	
ぶんぽう	文法	语法	
はつおん	発音	发音	
さる	猿	猴子	
えさ	餌	饲料	
おもちゃ	玩具	玩具	
えほん	絵本	画册	
えはがき	絵葉書	风景明信片	
ドライバー	Driver	螺丝起子	
ハンカチ	Handkerchief	手帕	
くつした		袜子	
てぶくろ	手袋	手套	
ゆびわ	指輪	戒指	
バッグ	Bag	手提包	
そふ	祖父	自己的祖父	
そぼ	祖母	自己的祖母	
まご	孫	孙子	
おじ		自己的叔伯舅	
おじさん		别人的叔伯舅	
おば		自己的婶姨	
おばさん		别人的婶姨	
おととし	一昨年	前年	
会话			
はあ		哦	
もうしわけありません	申し訳ありません	对不起	
あずかります	預かります	收存 保管	
せんじつ	先日	前些日子 前几天	
たすかります	助かります	得到帮助 得救	
読み物			
むかしばなし	昔話	传说 故事 	
ある		某 有的	
おとこ	男	男性	
こどもたち	子供たち	孩子们	
いじめます		欺负	
かめ		乌龟	
たすけます	助けます	救 帮助	
おしろ	お城	城堡	
おひめさま	お姫様	公主	
たのしく	楽しく	愉快地 快乐地	
くらします	暮らします	生活	
りく	陸	陆地	
すると		于是就 这么一来	
けむり	煙	烟 	
まっしろ	真っ白	洁白	
なかみ	中身	内容 装在里面的东西	
第42课			
つつみます	包みます	包 包围	
わかします	沸かします	烧开 使沸腾	
まぜます	混ぜます	混合	
けいさんします	計算します	计算	
あつい	厚い	厚的	
うすい	薄い	薄的	
べんごし	弁護士	律师	
おんがくか	音楽家	音乐家	
こどもたち	子供たち	孩子们	
ふたり	二人	两个人	
きょういく	教育	教育	
れきし	歴史	历史	
ぶんか	文化	文化	
しゃかい	社会	社会	
ほうりつ	法律	法律	
せんそう	戦争	战争	
へいわ	平和	和平	
もくてき	目的	目的	
あんぜん	安全	安全	
ろんぶん	論文	论文	
かんけい	関係	关系	
ミキサー	Mixer	搅拌器	
やかん	薬缶	水壶	
せんぬき	栓抜き	开瓶器	
かんきり	缶切り	罐头起子	
かんづめ	缶詰	罐头	
ふろしき	風呂敷	包袱皮	
そろばん	算盤	算盘	
たいおんけい	体温計	体温计	
ざいりょう	材料	材料	
いし		石头	
ピラミッド	Pyramid	金字塔	
データ	Data	数据	
ファイル	File	文件	
ある～		某 有的 	
いっしょうけんめい	一生懸命	拼命地	
なぜ	何故	为什么	
会话			
ローン	Loan	贷款	
セット	Set	套 组	
あと		其余	
読み物			
カップラーメン		杯面	
インスタントラーメン		方便面	
なべ		锅	
どんぶり		大碗	
しょくひん	食品	食品	
ちょうさ	調査	调查	
カップ		杯子	
また		另 其他	
～の　かわりに	～の　代わりに	代替	
どこででも		在任何地方都	
いまでは	今では	现在	
第43课			
ふえます	増えます	增加	
「ゆしゅつが～」	「輸出が～」	出口增加	
へります	減ります	减少	
「ゆしゅつが～」	「輸出が～」	出口减少	
あがります	上がります	上涨 提高	
「ねだんが～」	「値段が～」	价格上涨	
さがります	下がります	下降	
「ねだんが～」	「値段が～」	价格下降	
きれます	切れます	断了	
「ひもが～」	「紐が～」	绳子断了	
とれます		脱落 落下	
「ボタンが～」	「Buttonが～」	纽扣脱落	
おちます	落ちます	脱落 掉下	
「にもつが～」	「荷物が～」	行李掉下	
なくなります		丢失 用尽了	
「ガソリンが～」	「Gasolineが~]	汽油用尽了	
じょうぶ「な」	丈夫「な」	结实的 健康的	
へん「な」	変「な」	奇怪的 不寻常的	
しあわせ「な」	幸せ「な」	幸福的	
うまい	美味い	好吃的 擅长于	
まずい	不味い	不好吃的	
つまらない		无聊的	
ガソリン	Gasoline	汽油	
ひ	火	或	
だんぼう	暖房	暖气	
れいぼう	冷房	冷气	
センス	Sense	品味	
いまにも	今にも	马上 不就 眼看	
わあ		哇 哦	
かいいん	会員	会员 成员	
てきとう「な」	適当「な」	适当的 合适的	
ねんれい	年齢	年龄	
しゅうにゅう	収入	收入	
ぴったり		正合适的	
そのうえ		加之 而且	
～といいます		叫~	
読み物			
ばら		玫瑰	
ドライブ	drive	驾车兜风	
第44课			
なきます	泣きます	哭	
わらいます	笑います	笑 微笑	
かわきます	乾きます	干	
ぬれます	濡れます	湿 潮湿	
すべります	滑ります	滑	
おきます	起きます	发生	
「じこが～」	「事故が～」	发生事故	
ちょうせつします	調節します	调节	
あんぜん「な」	安全「な」	安全的	
ていねい「な」	丁寧「な」	礼貌的 恭敬的 仔细的 	
こまかい	細かい	小的 细小的 详细的	
こい	濃い	味道浓的 颜色深的	
うすい	薄い	味道淡的 颜色浅的	
くうき	空気	空气	
なみだ	涙	眼泪	
わしょく	和食	日式饭菜	
ようしょく	洋食	西式饭菜	
おかず		菜	
りょう	量	分量	
～ばい	～倍	~倍	
はんぶん	半分	一半	
シングル	Single	单人间	
ツイン	Twin	双人间	
たんす	箪笥	衣柜	
せんたくもの	洗濯物	洗的衣服	
りゆう	理由	理由	
会话			
どうなさいますか		你想要怎么样？	
カット	Cut	剪发	
シャンプー	Shampoo	洗发水	
どういうふうになさいますか		你准备怎么做？	
ショート	Short	短发	
～みたいにしてください		请剪成~	
これでよろしいでしょうか		这样行吗？	
「どうも」おつかれさまでした		您辛苦了	
読み物			
いやがります	嫌がります	讨厌 不喜欢	
まだ		另外	
じゅんじょ	順序	顺序	
ひょうげん	表現	表现 表达	
たとえば	例えば	例如	
わかれます	別れます	分开 分离	
これら		这些	
えんぎが　わるい	縁起が　悪い	不吉利	
第45课			
あやまります	謝ります	道歉	
あいます	遭います	遇到 遭遇 发生	
「じこに～」	「事故に～」	发生事故	
しんじます	信じます	相信 信任	
よういします	用意します	准备	
キャンセルします	Cancelします	取消	
うまくいきます		顺利进行	
ほしょうしょ	保証書	保证书	
りょうしゅうしょ	領収書	收据	
おくりもの	贈り物	礼物	
まちがいでんわ	間違い電話	打错的电话	
キャンプ	Camp	露营 帐篷	
かかり	係	担任某项工作的人	
ちゅうし	中止	中止	
てん	点	点 分	
レバー	Lever	杆 	
「～えん」さつ	「～円」札	（日元）纸钞	
ちゃんと		规规矩矩 确实 完全	
きゅうに	急に	突然	
たのしみにしています	楽しみにしています	期待着 盼望着	
いじょうです	以上です	到此结束	
会话			
かかりいん	係員	工作人员	
コース	Course	路线	
スタート	Start	开始 出发	
～い	～位	第~名	
ゆうしょうします	優勝します	获得冠军	
読み物			
なやみ	悩み	麻烦 烦恼	
めざましどけい	目覚まし時計	闹钟	
ねむります	眠ります	睡觉	
めがさめます	目が覚めます	醒来	
だいがくせい	大学生	大学生	
かいとう	回答	回答	
なります	鳴ります	叫 响	
セットします		组成套	
それでも		尽管如此 可是	
第46课			
やきます	焼きます	烧 靠	
わたします	渡します	递交 交给	
かえってきます	帰ってきます	回来	
でます	出ます	离开 出发	
「バスが～」	「Busが～」	巴士发车	
るす	留守	不在家	
たくはいびん	宅配便	快递	
げんいん	原因	原因	
ちゅうしゃ	注射	注意 打针	
しょくよく	食欲	食欲	
パンフレット	Pamphlet	简介	
ステレオ	Stereo	音响	
こちら		我们这边	
～のところ	～の所	~的地方	
ちょうど		正好 刚好	
たったいま	たった今	刚才	
いまいいでしょうが	今いいでしょうが	现在可以吗？	
会话			
ガスサービスセンター	Gas service center	瓦斯服务中心	
ガスレンジ	Gas range	瓦斯炉	
ぐあい	具合	情况	
どちらさまでしょうか	どちら様でしょうが	您是哪位	
むかいます	向かいます	向~去	
おまたせしました	おまたせしました	您久等了	
読み物			
ちしき	知識	知识	
ほうこ	宝庫	宝库	
てに　はいります	手に　入ります	到手	
システム	system	系统	
たとえば	例えば	例如	
キーワード	keyword	关键词	
いちぶぶん	一部分	部分	
にゅうりょくします	入力します	输入	
びょう	秒	秒	
（ほんが）でます	（本が）出ます	出版（书）	
第47课			
あつまります	集まります	集合	
「ひとが～」	[人が～」	人集合	
わかれます	別れます	分摊 分手	
「ひとが～」	[人が～」	与人分手	
ながいきします	長生きします	长寿	
します			
「おと／こえが～」	「音／声が～」	有声音 有响动	
「あじが～」	「味が～」	有味道	
「においが～」		有气味	
さします	差します	撑开	
「かさを～」	「傘を～」	撑伞	
ひどい	酷い	严厉的 严重的	
こわい	怖い	可怕的	
てんきよほう	天気予報	天气预报	
はっぴょう	発表	发表	
じっけん	実験	实验	
じんこう	人口	人口	
におい	におい	气味	
かがく	科学	科学	
いがく	医学	医学	
ぶんがく	文学	文学	
パトラー	Pandora	警车	
きゅうきゅうしゃ	救急車	救护车	
さんせい	賛成	赞成	
はんたい	反対	反对	
だんせい	男性	男性	
じょせい	女性	女性	
どうも		总觉得	
～によると		根据	
会话			
こいびと	恋人	恋人	
こんやくします	婚約します	订婚	
あいて	相手	对方 对手	
しりあいます	知り合います	相识	
読み物			
へいきんじゅみょう	平均寿命	平均寿命	
くらべます	比べます	比较	
はかせ	博士	博士	
のう	脳	脑	
ホルモン		荷尔蒙	
けしょうひん	化粧品	化妆品	
しらべ	調べ	调查	
けしょう	化粧	化妆	
第48课			
おろします	降ろします、下ろします	放下 卸下	
とどけます	届けます	送到 呈报	
せわをします	世話をします	照顾	
いや「な」	嫌「な」	讨厌的 不愿意的	
きびしい	厳しい	严格的 强硬的	
じゅく	塾	补习班	
スケジュール	Schedule	日程	
せいと	生徒	学生	
もの	者	（特定情况下的）人	
にゅうかん	入管	出入境管理局	
さいにゅうこくビザ	再入国ビザ	再入境签证	
じゆうに	自由に	自由地	
～かん	～間	中间 期间	
いいことですね		那很好	
会话			
おいそがしいですか	お忙しいですか	您忙吗？	
ひさしぶり	久しぶり	很久	
えいぎょう	営業	营业 销售	
それまでに		在那之前	
かまいません		没关系 别介意	
たのしみます	楽しみます	享乐 快乐	
読み物			
もともと		原本 原来	
～せいき		世纪	
かわりを　します	代わりを　します	代替	
スピード		速度	
きょうそうします	競走します	赛跑	
サーカス		马戏团	
げい	芸	技艺 技能	
うつくしい	美しい	美丽	
すがた	姿	姿势 姿态	
こころ	心	心 心情	
とらえます		打动 抓住	
～に　とって		对于~来说	
第49课			
つとめます	勤めます	工作	
「かいしゃに～」	「会社に～」	在公司工作	
やすみます	休みます	睡觉	
かけます	掛けます	坐	
「いすに～」	「椅子に～」	坐在椅子上	
すごします	過ごします	度过 过	
よります	寄ります	顺路去	
「ぎんこうに～」	「銀行に～」	顺路去银行	
いらっしゃいます	在 来 去（います　行きます　来ます）的尊敬语		
めしあがります	召し上がります	食べます　飲みます尊敬语	
おっしゃいます		言います尊敬语	
なさいます		します尊敬语	
ごらんになります	ご覧になります	みます尊敬语	
ごぞんじです	ご存じです	知って　います尊敬语	
あいさつ		问候 寒暄	
はいざら	灰皿	烟灰缸	
りょかん	旅館	旅馆	
かいじょう	会場	会场	
バスてい	バス停	公车站	
ぼうえき	貿易	贸易	
～さま	～様	桑尊敬语	
かえりに	帰りに	回来的途中	
たまに		偶尔	
ちっとも		一点也不	
えんりょなく	遠慮なく	不客气	
会话			
～ねん～くみ	～年～組	~年~班	
では		那么	
だします	出します	发	
「ねつを～」	「熱を～」	发烧	
よろしくおつたえください	よろしくお伝えください	请带我问好	
しつれいだします		告辞了	
読み物			
こうし	講師	讲师	
おおくの	多くの	很多的	
さくひん	作品	作品	
じゅしょうします	受賞します	获奖	
せかいできに	世界的に	世界性	
さっか	作家	作家	
～で　いらっしゃいます		是	
ちょうなん	長男	长子	
しょうがい	障害	障碍 障碍物	
おもちです	お持ちです	有	
さっきょく	さっきょく	作曲	
かつどう	活動	活动 行动	
それでは		那么	
第50课			
まいります	参ります	行きます　来ます（谦逊语）	
おります		います（谦逊语）	
いただきます		食べます　飲みます　もらいます（谦逊语）	
もうします	申します	言います（谦逊语）	
いたします		します（谦逊语）	
はいけんします	拝見します	みます（谦逊语）	
ぞんじます	存じます	しります（谦逊语）	
うかがいます	伺います	聞きます　行きます（谦逊语）	
おめにかかります	お目にかかります	会います（谦逊语）	
ございます		あります（谦逊语）	
～でございます		です（谦逊语）	
わたくし	私	わたし（谦逊语）	
ガイド	Guide	导游	
おたく	お宅	府上	
こうがい	郊外	郊外	
アルバム	Album	相簿	
さらいしゅう	再来週	下下周	
さらいげつ	再来月	下下个月	
さらいねん	再来年	后年	
はんとし	半年	半年	
さいしょに	最初に	最初	
さいごに	最後に	最后	
ただいま	ただ今	刚才	
会话			
きんちょうします	緊張します	紧张	
ほうそうします	放送します	播放	
とります	撮ります	摄录	
「ビデオに」	「Videoに」	录影	
しょうきん	賞金	奖金	
しぜん	自然	自然	
きりん		长颈鹿	
ぞう	象	象	
いろ		时候 时期	
かないます		实现	
「ゆめが～」	「夢が～」	实现梦想	
ひとことよろしいでしょうか		我能说一句话吗？	
きょうりょくします	協力します	协力 合作 协作	
こころから	心から	衷心	
かんしゃします	感謝します	感谢	
読み物			
おれい	お礼	感谢 致谢	
はいけい	拝啓	拜	
うつくしい	美しい	美丽	
お元気で　いらっしゃいます		您好吗	
めいわくを　かけます	迷惑を　かけます	添麻烦了	
いかします	生かします	活用	
おしろ	お城	城堡	
けいぐ	敬具	谨此	
			